xxxxxxxxxxxxxxxxxxxxxxxxxxxxxxxx
xx......x........x.......x....xx
x.....xxx......e.x.......x.....x
x....p...........x.......x.....x
x...................T....x.....x
x.......xxxxx......xxxxx.......x
x...x...x..............x.......x
x...x.......C..........x.......x
x...............xxxxxxxx.......x
x.......x.......x..............x
x...xxxxx.......x.......x......x
x..........x...ex.......xxxxxxxx
x..e.......x...xx......Cx......x
x.....xx.......xx.......x......x
x.......................x......x
xxxx....x..........xx..........x
x.......x.....C................x
x.......x..............x.......x
x..T....x..............x.......x
x.....xxxxxxx......xxxxx.......x
x.....x..........x.....x.......x
x..C..x.............C..x.......x
xx....x..........x............xx
xxxxxxxxxxxxxxxxxxxxxxxxxxxxxxxx



