xxxxxxxxxxxxxxxxxxxxxxxxxxxxxxxx
xx...............x...C...x....xx
x..............e.x.......x.....x
x....P...........x.......x.....x
x..xxxx.............T....x.....x
x..................xxxxx.......x
x...xxxxx..............x.......x
x...xc.................x.......x
x...x...........xxxxxxxx.......x
x.......x.......x..............x
x...xxxxx.......x.......x......x
x..........x...ex.......xxxxxxxx
x..........x...xx......Cx......x
x.....xx.......xx.......x......x
x.......................x......x
x.......x..........xx..........x
x...e...x...c..................x
x.......x..............x.......x
x..T....x..............x.......x
x.....xxxxxxx......xxxxx.......x
x.....x..........x.....x.......x
x.....x.............C..x.......x
xx....x..........x............xx
xxxxxxxxxxxxxxxxxxxxxxxxxxxxxxxx
