xxxxxxxxxxxxxxxxxxxxxxxxxxxxxxxx
xx...............x.......x....xx
x.......c......e.x.......x.....x
x....P..c........x.......x.....x
x.....ccc...........T....x.....x
x..................xxxxx.......x
x...x...x..............x.......x
x...x.......c..........x.......x
x...............xxxxxxxx.......x
x.......x.......x..............x
x...xxxxx.......x.......x......x
x..........x...ex.......xxxxxxxx
x..........x...xx......Cx......x
x.....xx.......xx.......x......x
x.......................x......x
x.......x..........xx..........x
x...e...x.....c................x
x.......x..............x.......x
x..T....x..............x.......x
x.....xxxxxxx......xxxxx.......x
x.....x..........x.....x.......x
x..c..x.............C..x.......x
xx....x..........x............xx
xxxxxxxxxxxxxxxxxxxxxxxxxxxxxxxx
